11111111111
10C1000C001
10110E01011
1P0000000C1
11111111111