111111111111111111111111111111111111
10010000000C111111111111111111111111
100001111100111111111111111111111111
1P0011E00000111111111111111111111111
111111111111111111111111111111111111