1111111111111
10010000000C1
1010011111001
1P1011E000001
10000C00C0001
1111111111111